Boehner| Obama |psychic shield 
RealSexEdSavesLives | AIDS
Amanda Ben| Hyde UTD | police
steelers | steelernation | Obama
roadrapers|imonaboat|85degrees|november|globalwarming|brudders| itsnovember
Holister models| mall | blackfriday | hottie| models| shopping|abs
decemberwish | BEROTOT | 
New York| usa | timesquare|april|2012
brittanyybetch | newyork | ginny_329|rude |red|car
police | fivepointoh| mustang
webisodes | police| jaredbrady| heavenkimchi
Obama | Jordans
spolobsteashdash |79miles |cancer |movember
mom|cairo|airpo|back|welcome|home
homosexuality |sorrynotsorry |notoffensive |religion |truth
expresion |a |religion|culture
razor | NFL |Gillette
thatshitcray |crazy|funny| hurricanesandy| brad
Sandy |Terra Nova Scout Group| pccrovers
Cairo
aidsawareness |jci |jciphilippines |STD|HIV|AIDS
White Obama 
decemberwish 
Obama | American Citizens| NDAAruling| tcot
football |gay |gayboy |gayboys |gayguys |gaylove |gaymarriage |freedom |kissgay |boyloveboy|lgbt |freelove |emokiss| gayrights
beautiful |lovo |my |dog |white |like |android |jj |followme
Brooklyn | flooding| hurricanesandy|friends| noheast| Prayers
UEFA Champions League | ChampionsLeague| FCBarcelona|FCB| Barça| CampNou| FCBMuseum| Messi
Obama |OBAMA|President|BLACK|JET
Drugs | Buddha
DecemberWish | lolz| youwish
AugustWish | SeptemberWish| OctoberWish| NovemberWish| DecemberWish| Happiness
Hurricane Sandy| hotelcafe| rockdrive|friends|help |hurricanesandy 
Payaaye hardy| blackfriday| pearls|shopping |nomess|hollahz | pagnit| iwassnoringtoo |ohwell
OBAMA | LMFAO| Thug
SternShowComiX | Howard AGT Round| MFBrooklyn | HOWARDSTERN| STERNSHOWCOMIX|zenabuddysgirl | southernjew
Religion | Relationship
AFetusIsAHuman | antiaboion| Abolionist| aboion| Fetus | AbolishHumanAboion| babies| EndAboion|Love| ChildrenAreABlessing| Miracles | ProLife | StopAboion| SpeakLife| SaveOurBabies| NationalRightToLife|latinobaby | latinababy|40daysforlifeLR | 40daysforlife| BlackGenocide |blackbaby |whitebabies|whiteWomen| LatinaWomen |ArkansasRightToLife
pitbull | Montreal|11:59 |globalwarming
blackfriday | occupy |ola |tents
Da Accessories | MercedesVision | Religion|Fendi | LVblanket |SF49ers |HallOfFame |S550 |Blessed
ElenaGornall1 | EmilyStua_X| caitmurphy|MemoriesIWontForget
Shibuya | japan| World AIDS Day|hiv|aids|instadaily|instapic
Argos | Grey Cup|2012
tamore |1mother
thrift store | 50% |blackfriday 
auntie | newyork| babyshower |cousin| lovethem |pay |stophashtagging 
newyork | brooklinbridge| nightime
AGT performance
championsleague | zenith| win
MemoriesIWontForget 
DecemberWish
gay |gayboy |gayboys |gayguys |gaylove |gayrights |gaymarriage|love |lgbt |kissgay |boyloveboy |freedom |freelove
Harry | Christmas| twitcam|2010
Movember Mustache| November| cancer| donations
lacaafaiR |Jay-z|Obama
November 27th| Tahrir | Square| November|27th| TIME| Bobby Ghosh| ghoshworld
pizza | vodka| food |foodporn|goodness|grandma | angelinas| newyorkpizza
gays | America| truth |interesting |aboion
Liverpool | Aids Day
Schoolhouse Rock | Election| Movie| Central SCHOOLHOUSE ROCK | ELECTION COLLECTION|Schoolhouse Rock|The Preamble|September 23, 2008
galatasaray |championsleague
DIVA |dayofthediva Eagle Manchester |World AIDS Day |katherineellis1
BlackFriday |shopping |spree |1DWorldMerch |onedirection
lukebullock| OBama
Daisy| jerk store
AHH |winter |mornings|Decemberwish
Obama |KevinHa |RP
Cyber Monday purchase |Police Box leggings |Tardis leggings |blackmilkclothing |awesomeness
vaneycj |aids
Obama
todayshow |yolo |globalwarming| rocking| morning| night
Alinin telefonundan|galatasaray |championsleague |cimbom |cimbombom |ultraaslan |instagram
Horse shoes |jeans |true
bird |seaguls |malibu |november |globalwarming
ocean acidification |WA |Seattle |tvnews |globalwarming |photographers
allietotheb| band-aids| silver| radness
human| history| skeptical| religion
nofilter |Browns |NFL |Cleveland |GoBrowns
DecemberWish |Happy Bihday |TqALLAH |LoveISLAM |LoveUallLillahiTaala
Obama| WhoDat
Dank| Funksticks|sandy |benefit
Election night
Mohamed Mahmoud 2012|protest |police |riot |revolution |tahrir |clashes |cairo |egypt |egyptian |me |usefsalah |ua07 |march |acab |anarchy |youth |photography |photographer |photooftheday |picoftheday |instagram |instacanvas |teargas |graffiti |strong |soldiers |filmmaker |cinema |followme |chants
uniform|NFL
bahrain
NOM DE LA MARQUE |TAILLE| EMAIL
grandma| sweetest lady| cancer
religions people
Obama| Bush| tcot| sgp| teapay|JEZEBEL
theater| visual aids
newyork
Cotton Candy|Cairo
RIP |Young Prince| young homie| cancer| CureFIP
Philippine |Crame Church |police
cancer event| alexthao| terryhe| shimmycocopuffsss
twitter|aboion
Pandora| election season| Obama
|lavishemporium |boutique |blackfriday |blackfridaysale |blackfriday2012 |thanksgiving |thanksgivingsale |cybermonday |armcandy |accessories |brazilianhair |curlyhair |handbags |idohair |isellhair |indianhair |jewelry |kinkyhair |laceclosures |malaysianhair |order |peruvianhair |quality |sale |shoes |straighthair |virginhair |virginextensions |wavyhair
Dogs |Cute |MobCam |InstaDogs |InstaAnimals |Adorable |Pets |FoundAndLost
Post-election |rice |suculentBCN
newyork
backyard |bar |parkslope |brooklyn |newyork |brunch |egg |yolk |yum |food |foodporn
Finna| Raising| Canes| starving|vbf1 |blackfriday |shopping |leftovers |text |versagram |versalove
Work flowww |bakers |blackfriday |death
movie| RealHughJackman| decemberwish| bihday gift
Japan| election| remote vote
fuckoff| Zimmerman| deserve| life| photo|staged |lame |killer |poor |trayvon
{}
MemoriesIWontForget
gayboy |gayboys |gayguys |gaymarriage |gayrights |freedom |freelove |street |lgbt |love |onedirection |harrystyles |luoisthomilison
Teenage Cancer Trust |2nd year |professorgreen
frsharabianluv |subway |nyc |newyork| Subway stories| vol.1 | zlbg
Tokyo Gore Police |Dvdrip |movie download|Actors |Eihi Shiina Cay Izumi Mame Yamada Yukihide Benny Ikuko Sawada Itsuji Itao Akane Akanezawa Ayano Yamamoto Jiji|Tsugumi Nagasawa Download| Bloody good|New York |Post Strap| April|Eihi Shiina | Itsuji Itao|Keyman|Yukihide Benny| Tokyo Police Chief|Jiji|Barabara-Man|Ikuko Sawada|Tokyo Gore Police|Wikipedia|Japanese-American|Yoshihiro Nishimura|Wikipedia|Rotten Tomatoes Review|Tokyo Gore Police | Netflix Tokyo Gore Police
WesleySafadao|GarotaSafada|app|android
$150|prostate cancer|Ronald McDonald
kylegibbons|jelluhfish|aids
HurricaneSandy|donations|UConnCountry|BleedBlue
Lsb love|lsb|girllovegirl|gay|gayboy|gayguys|gaylove|gayrights |gaymarriage|freedom|freelove|love|lgbt
airpo police
movember|Day 16|cancer
election day|Doad|Obama|blue parka
Mexes|Chilena|Francia|Italia|Venezuela|UCL|ChampionsLeague|Calcio|Futbol|ACMilan|Golazo|Gol|ForzaMilan|Rossonero
Love|religion
Hunting Trophy|varMITT|exposeLiberal|co2hog|P2 |tcot|teapay|gop|DEMS|LIBERAL
memoriesIwontforget
money|Teenage Cancer Trust
Tahrir square|egypt|tahrir|cairo|revolution|ihatemuslimbrotherhood|freedom|freeegypt|instagram|instalife
Amen|spawnio20|City|CL|ChampionsLeague
Equality breakfast|gay|gayboy|gayboys|gayguys|gaylove|gayrights|gaymarriage|kissgay|freelove|freedom|lgbt
Micky mouse|NewYork|newyorkcity|NYC|TimeSquare|selfie|city|micky|mickymouse
daddy|BlackFriday|shopping|golf
kaka|thebest|bernabeu|championsleague|realmadrid
Tahrir|Cairo|egipto
Hea Smile |kinggoldchains |tyga|kingcairo |SoSweet|Tyga|Cairo |King|Studio|Family |Love|Baby|LastKings |Kingin |HardWork |Small |Happy
breast cancer helmets
Barbeon|police|old lady|parking lot|KMa|police|SUV|crusier|drugs|guns|ticket|taxdollarsatwork
Global warming|Baltimore|GlobalWarming
LLS|Sandy Little Cheeks
aboion clinic|oxymoronic
Ghost corner|Cairo|Illinois
Happy Election Day|VOTE
CountryStrong|Travis|cutie|cancer|favorite
game|nfl|nyg|gmen|football|sunday|funday
cristians|muslims|religion|church|mosk|extremist|terrorist|911|wtc|binladen|osama|osamabinladen|alqaeda|alqaida|al-kaida|mudjahedin|taliban|revolution|ignorence|nonesense
Red|White|Blue|Christmas Tree|re-election|President Barack Obama
bigtiggershow|Big Bro|Gmail|HIV/AIDS Awareness Record| Interview
little adventure|Rome|Newyork
{}
I love you|Henry|hate cancer
New|Zimmerman|Dj Clue voice|Trayvon|toast
religion|atheism
Hryda|onmyPboishit|thuglifer|Blackfriday|imblackeveryday|blacksheep|backonmyfeet|stillupstillaintwent2sleep|Jumma|prayerday|Rip|V12BmR
Same Sex Marriage Shi|gaymarriage|equality|fckh8|gay|lesbian|LGBT
best grandmother|Bibi|BlackFriday|Love|Amazing
Dixie gurdwara|textbook|world religion class|uoft
Pay hard|police|pay
tbt|Halloween|weathermen|hurricaneSandy
{}
hands up|budha|religion|incense|techno|song|memories
best night
DecemberWish|Less stress|Less pain|Less problems|Less tears|More happiness|More laugh|More love
GEORGE ZIMMERMAN|JUSTICE
little man|rocking Burberry|True Religion|Olympics
Boo|football|nfl|cfl|football|qualitytime|putaringonit
African Election
architecture|postsandy|hurricanesandy|nj
|PhonseeMac |HeyBoo|YouLoveShauna|cancer 
justinbieber|Obama
Decemberwish|december|ig|igers|igdaily|photodaily|mymonth|hashtags|nofilter|tweegram|instagood|instagram|instamood|instalikes|instaphoto|instafamous|instafollow|followforfollow|likesforlikes|f4f|l4l|10likes|smile|happy
gas problem in NYC|sandy|ny|nyc
bitches|repost|dat_nigga_mase|Magic|Johnson|HIV|Aids|OhBabyiLikeItRaw
good joke|fantasy|aboion|flop|nfl|fantasyfootball
Snacks to eat|pinkelly|oreos|hurricanesandy
Ur|Funny|Football|CyberGift|Troops|ISS|Seahawks|myCancer|Journey
tree|snow|ig|igers|instagram|fallentree|hurricanesandy|sandy|winter|autumn|seasons|jj|photooftheday|likeforlike|picoftheday|leaves|cold
9 months|One Election|TrayvonMain
{}
collection|hellokitty|newyork|shotglass
Bad religion
FashionablyDelicious|oakville|cancer|fundraiser
BlackFriday|purchases|2am|sephora|freshfounder|lushvalleyfair|julepmaven
Obama|Kingcairo
One Direction|Congrats|One Direction|Ovarian Cancer
Rocking|99 problems|Obama
PARIS SAINT|GERMAIN|PSG|PSGPOO|C1|Championsleague|Win|Paris
election predictions
AIDS Project|Los Angeles|World AIDS Day|FoodDrive 
breast|cancer|awareness|soccer|game|vsyulee|november27th|bethere|shootout|prizes|530|720|wearpink
Tahrir square|Today|27November2012|protest|revolution|Tahrir|Square|Cairo|Egypt|tahrirsquare|brutal|police|force|teargas|gas
PRESIDENT AT STARBUCKS
cancer|karemcitac|pabloacap
First Lady|firstlady|obama|michelleobama|merica|usa
pregnant|aboion|decent|GTFOH|TheThirst
growing up|MemoriesIWontForget|Graduation2011|unibocconi
read tonight|AudacityOfHope|Obama|BarackObama|ProudDad
decemberwish|Oppa
Souls up|spirit is back|good old days|tahrir|egypt|cairo|travel
anti-Obama|FB page|cousins|Joe Di 
Rap And Religion|book release pay|The Diplomat
revenge|antagonise|football fans
Football Skills|Clinic
GoT_Cast|Game of Thrones
telltalegames|holy smokes telltale|Game of thrones
SarahSarah256|WinceyWillis1|India|mega millionaires|animals
dallxscxm|YourBoyMyles|animals
InnovativeHindu|ndtv|Headlinestoday|Muslim Org PFI |Hindu Temple|Calicut|Kozhikode|Sunday
Football Season
RyanBrownWJOX|JayHopeIsHere|Joey35209|UAB|football program
JeffSolochek|Florida superintendents|school board members|testing concerns|recommendations|ErikaDonalds|edFL 
SteveStfler|EDUCATION SYSTEM
SDLPlive|gerardmcd93|SDLP|povey|living wage|belfast|mid Ulster council|Mencap_NI
AnishNation|Job oppounity|Education Development Officer|Nipissing Campus|sharethis
Robby Ratan|avatars|education|MSUComASci|MSU_ITL
NYSenate|New Yorkers|NYGovCuomo|education agenda|legislator
Sale|Allen|Edmonds|GRIDIRON|Oxfords|Brown Football|Grain Leather
StPetePD|animalcruelty|animals
Game of Thrones|$1.99|GameOfThrones|GRRMspeaking
Photos Of Bollywood Stars
JeanneBaram|Iain Duncan Smith|food bank charity|bankers|povey
zepvv|international football
allthelovelouis|harry|louis|football game
90sfootball|James Richardson|Italian cafe|Football Italia
angela_std|Animals|ApoyoLeyAnimal087
EssexFBU|Brigade|FBU education course|WoleyHall|EssexFBU|NotGoingAway
Baylor|football|Texas
Daily Bread|povey|hunger|WhyWePray
Education|money|ignorance
University of Saskatchewan|students|tuition fees|free education
rightsnet|Iain Duncan Smith|food bank charity|TrussellTrust
ORGY PORGY|European Invasion|DNA|Origins Of Modern Europeans|IFLScience
ndtv|Japan|technology transfer pacts|Reserve Bank of India 
MindyRosier|Public Education Warriors Unite|AllKidsNeedht|quadgurl|CMZR|RodneyJordan4|TruthinTeaching|teachin1100
philo_quotes|education|proper training|nursery|Plato
ndtv|NationalAwards|Priyanka Chopra|small town girl|Kangana Ranaut
Domestic violence|womans|financial dependence|man|woman education|livelihood
Man Ki Baat|Prime Minister|Narendra Modi|All India Radio News
outlawvern|SHE'S GOTTA HAVE IT|HOLLYWOOD SHUFFLE|smash
Hollywood|dneedles12|live repo|LA|tonight|WISN12News|Badgers|Sweet16
Okies4Carrie|Carrie Underwood|Hollywood Bowl|Surprise Guest|Mr. Randy Travis
NBCLA|WillFerrell|Hollywood|Fame star
RevRichardColes|Paul Hollywood|mille feuilles
Hollywood|Star|Interview Magazine|January 1995|Julia Robes|Tim Robbins|Laurence Fishburne|BestSeller|eBay
A-List|celebrity|Kim Kardashian|Hollywood|iPhone
BrooksBeau|Hollywood|weed
Mr. Hollywood|Mega Deal|Thursday, March 26|gluten
JBCrewdotcom|Justin Bieber|West Hollywood|CA
dollllllfaceee|Kim Kardashian|Hollywood
TheAegiMaster|Harlem|Hollywood|Jackson|Mississippi
Singer|Actress|MileyCyrus|CD|Jul-2008|Hollywood|Deals|Bargains
Lady9NewOrleans|Hollywood|history|black men|womanly roles
Iam1izzo|LeoDiCaprio|young R&B celebrities|Hollywood|YoungHollywood|NextUp|Movies|etnow|TM
DuncanWhitehead|whodunnit|mystery|books of the decade|Hollywood Times|kindleespañol|kindleunlimited|kindle
jesu|Young Hollywood|celebrity-focused|Apple TV|Apple TV|paulz
Big12SposESPN|Hollywood|dneedles12|live repo|LA|tonight|WISN12News|Badgers
jesu|Young Hollywood|celebrity-focused|Apple TV|Apple TV|paulz
JOPDreke|Secret Behind Liam|Hollywood Celebs|Explosive Muscle Gains
HOLLYWOOD|COLLAGE POSTER|NICE AWORK
JColeNC|Forest Hills|Hollywood|Big Sean|YG. Jeremih
Queens Of The Stone Age|seguira|Cranberries|Hollywood
teresaamejiaa|Kim K|Hollywood
B-List celebrity|Kim Kardashian|Hollywood|iPhone
Hollywood}Free Games|Kim|Hollywood|Game
NerdPowersUnite|Lady9NewOrleans|Hollywood|history|emasculating black men
E-List celebrity|Kim Kardashian|Hollywood|iPhone
First millions|Hollywood Film|TV|music moguls
ayeeitsbeccaa|Stars&Cash|Kim|Hollywood
dollfacetrece|Stars&Cash|Kim|Hollywood
hamilt4|Stars&Cash|Kim|Hollywood
Indiegogo|kickstaer|Hollywood movie trailer|growthhacker
Movie Finance|Hollywood|TOMOOffMarket
VanityFair|Happy Bihday|Steve McQueen|Hollywood Cool
Iam1izzo|Big S/O 2|LeoDiCaprio|young R&B celebrities|Hollywood |YoungHollywood|NextUp|Movies |etnow|TM
TheAVClub|ComedyCentral|new series|Hollywood|FL|
A Deco|Old Hollywood Affair|Wedding Decor|pheasant feathers
ArkansasAuthors|AceCollins|author|Man's Best Hero|Hollywood Lost
Highway to Hollywood Trailer|YouTube
GOPLdrBrianKolb|Hollywood Film|TV|millions|music moguls
ATTI|ML04orange|Bus|Sam's Club|Orange South|Stopis Hollywood|Domain Apts
Monatana Ave|Main St|Beauticate|SantaMonica|Hollywood|cool beachy cousin
YouTube|video|kiss_network|Hollywood Traincase|LOLA V
HOLLYWOOD THEATER ROW|Hollywood|East Hollywood Chamber of Commerce
TheAVClub|ComedyCentral|Hollywood|FL
_Akanshagautam|Meanders|Mike Reyfman|Applebees|Landscapes|Photography|Nature|Travel
archeteer|vic_Pascual|photography|architecture|Santiago Calatrava|City of Arts and Sciences|Valencia|Spain
Photography books|Understanding Exposure|itslikereally
AUTOUPDATED Blogger blogs
_Akanshagautam|Meanders|Mike Reyfman |Applebees|Landscapes|Photography|Nature|Travel
Top Secret Photography Tutorials|Trick Photography|Special Effects
monicatakvam|Renaissance|Photography|Prize 2015|RPP2015
About Page|Establishing Trust|photography|advice
Network_Easy|Landscapes Photography|Qualasha|mikeshoys|landscapes
Life|photography|negatives|develop
ExclusiveTailor|K|Photography
CutPics|Microscopic Photography
product|all-nighter|sunrise|neighbouring roof|Leicester|photography
UK Highland Photography|latest review|produ|yotpo
DWAWest|Monochrome adventures 120|picoftheday|Newhaven|Sussex|photography|landscape|blackandwhite|Leica 
Susanne|white backdrop|Carl Hult|YouPic|photography|PIcSher|TeamCanon
GORILLA MONSOON|LIVE|XIII PHOTOGRAPHY
love|candy|photography ellahaus|wedding|candybar|vancouverwedding
OnePerfectShot|LAWRENCE OF ARABIA|Director of Photography|Freddie Young | Director|David Lean
AnnieLyden|Barnes|V_and_A|S African photo tomorrow |NatGalleriesSco|NGSPonteCity
Springtime Fly
Director of Photography|Bryan Pereira|Scarborough Photographic Club|Ontario
mainlygems|photography student|ass|hand|cup
high school|choir| photography idk 
ggwildlife225|WildLondoner|WWTLondon|London|Wildlife|Photography
MatHombauer|conce|photography|flickr|group
book|photoshoot|nigga mean|Active Photography
RFWPPI 2015|wedding|porait|photography conference
Growth Of Video|Photography Business|Fstoppers
Awesome Examples Of Fashion Photography
Photography Market
DWAWest|Monochrome adventures|picoftheday|Newhaven|Sussex|photography|landscape|blackandwhite|Leica
RFWPPI 2015|wedding and porait|photography conference
photography
P41 Eisbrecher|Director of Photography
jasonburrows|Landscape|Loon Island Lighthouse|miketaylorphoto 
photography|photoofthed
master|flower photography|Mother Nature Network
Viewpoint and Angles|Photography
photography
Last night|photo shoot.
kapchur|photography|natural|canon|freelance|photos|videography
_Akanshagautam|Meanders|Mike Reyfman |Applebees|Landscapes|Photography|Nature|Travel 
EarthHourSA|Tourism|CT|EHchat
WalesAirForum|Roger Lewis|Cardiff Airpochairman|Cardiff|Wales|avgeek|WalestotheWorld
tibettruth|travel|trueTibet|tourism|erosion|Tibetan culture
tibettruth|trueTibet|sacred landscape|tourist theme park|China|terrorist regime|travel|tourism
Astronomical Tourism
tibettruth|trueTibet|tourist theme park|China|terrorist regime|travel |tourism
CatalanMuseums|Catalan Museum|tourism
Traveller24_SA|Tourism|EarthHourSA |EHchat
hany2m||tourism|Egypt|CAPMAS
tour|Skills Development Programme|Wakkerstroom Tourism
Turismo|Zaia|SmaGuide Tourism|Vinitaly
WWFSouthAfrica|Traveller24_SA|Tourism|global sustainability |EarthHourSA
geckobike|tourism|Tibet
Iran|Photos|Shiraz |Hafezieh|Nowruz
Tourism|Iran|MustSeeIran
ijen Crater|East Java|Indonesia |tourism|eastjava|holiday|kids|Indonesia
Atlantic City|tourism
ac |atlantic |jersey
HM|RoyalMuseumJo|Tourism |Jordan |ShareYourJordan |LoveJO |GoJordan |VisitJordan
Manchester|tourism  |sightseeing
AnasAlShariff|HM|RoyalMuseumJo|Tourism|Jordan |ShareYourJordan |LoveJO |GoJordan |VisitJordan 
tourism
meta_guide_lc|St. Lucia|Record-Breaking|Tourism Growth
AnasAlShariff|RoyalMuseumJo|Tourism in |Jordan |ShareYourJordan |LoveJO |GoJordan |VisitJordan
taxi driver| Artane|tourism
United States
th3programe|United States
njerudeee|Security|Kenya|Tanzania|tourism
TOURISM WEBSITE
Dmitris Tsoukalas|iamanathenian|private company|tourism|Athens|Greece|SoMeT15EU
instanusantara challenge|indonesia tourism|world|Gunung
London Mayor| Boris Johnson|tourism|London|Evening Standard
CCCU hospitality|tourism|logoideas | kentchoices
EstherPassaris |AMB_A_Mohammed|tourism sector
Japanese|hot spring|Kurokawa Onsen|Tokyo Olympics |Japan Tourism |Olympics
th3programe|United States
masterclassing|Digital Travel |Tourism Masterclass |Dubai|April 15th
North East|tourism
masterclassing|Travel|Tourism|Brandwatch
th3programe|United States
Iran|Photos|Shiraz |Hafezieh|Nowruz
Tourism |Iran |MustSeeIran
Post_Nigeria|FG|medical tourism|hospitals | Post-Nigeria
BittuSahgal|Rwanda|tourism|India
Post_Nigeria|FG|medical tourism|hospitals | Post-Nigeria|WeTriumphStill |IchooseGEJ
Head of School|Hospitality Management|Tourism|tourism|Ireland
oleebranch|Kyaninga Triathlon|The Mighty Rim|UGblogs |256Blogs |VisitUganda |Triathlon |Fitness |Fitfam
Humber East Liberal |stelmanflynnMHA|tourism guide
Tourism|Barcelona
